SO Cub_textures/BasicDarkWall.xpm
WE Cub_textures/BasicWall.xpm
NO Cub_textures/BearWall.xpm
EA Cub_textures/skullWall.xpm

F 220,100,0
C 225,30,0

111111111111111111111111111111111111
100000000000000000000000000000000001
100000000000000000000000000000000001
100000000000000000000000000000000001
100000000000000000000000000000000001
100000000000000000000000000000000001
100000000000000000000000000000000001
100000000000000000000000000000000001
100000000000000000N00000000000000001
100000000000000000000000000000000000
100000000000000000000000000000000001
100000000000000000000000000000000001
100000000000000000000000000000000001
100000000000000000000000000000000001
100000000000000000000000000000000001
100000000000000000000000000000000001
100000000000000000000000000000000001
100000000000000000000000000000000001
111111111111111111111111111111111111